9955551553
669539693E
A56BAC56C3
77BA8BF73A
A3AC4057AA
9AE73AA77A
8A93AAAD52
66AEEEE77A
A3C153D13A
B456D456C6
Entry: (0, 2)
Exit: (4, 4)
